SEEEEEEL
ETTTEEEL
EEEELLEL
ELEELLEL
EELEEEEL
EEELTTTL
EELEEEEL
EEEEEEEG